Чтобы перевести текст нужно использовать команду /translate
Далее требуется ввести текст и язык для перевода
Доступные языки:

en - Английский
zh - Китайский
ar - Арабский
ru - Русский
fr - Французский
de - Немецкий
es - Испанский
pt - Португальский
it - Итальянский
ja - Японский
ko - Корейский
el - Греческий
nl - Голладнский
hi - Хинди
tr - Турецкий
ms - Малайский
th - Тайский
vi - Вьетнамский
id - Индонезийский
he - Иврит
pl - Польский
mn - Монгольский
cs - Чешский
hu - Вергерский
et - Эстонский
bg - Болгарский
da - Датский
fi - Финский
ro - Румынский
sv - Швецкий
sl - Словецкий
fa - Фарси
bs - Боснейский
sr - Сербский
fj - Фиджийский
tl - Филипиннский
ht - Гаитянский Креольский
ca - Каталонский
hr - Хорватский
lv - Латышский
lt - Литовский
ur - Урду
uk - Украинский
cy - Валлийский
ty - Таити
to - Тонганский
sw - Суахили
sm - Самоанский
sk - Словацкий
af - Африканский
no - Норвежский
bn - Бенгальский
mg - Малагайский
mt - Мальтийский
otq - Отоми Керетаро
tlh - Клингонский/Тлинганский хол
gu - Гуджарати
ta - Тамильский
te - Телугу
pa - Панджаби
am - Амхарский
az - Азербайджанский
ba - Башкирский
be - Белоруский
ceb - Кебуано
cv - Чувашский
eo - Есперанто
eu - Баскский
ga - Ирландский
